11111111111
1000P000EC1
11111111111
