1111111111111111111111111111111
10P0000001000000000000000100001
100000100100000000000000000E001
1000001001000000C00000000111111
1000001C01111111111111000000001
1000001111000000000000000000011
1000000C0000000C000000000000001
1111111111111111111111111111111
