1111111111111111111111111111111
1000001001000010000000000100001
1000P0000000000000000000000E001
1000001011000000C00000000111111
1000001C01111111111111111100001
1000001111000000000000000000011
1000000C0000000C000000000000001
1111111111111111111111111111111
