11111111111
100000P0E01
1010100c0DASDDSAAAAAAAAAAAAAAAAAAAA01
10100000001
11111111111
