11111111111
1F00P000E01
11111111111
